[
[5,5,1,0,0,1,5,5,4,5,5,4,5,5,4,5,5,4,5,5,1,0,0,1,5,5,4,5,5,4,5,5],
[5,5,1,0,0,1,5,5,4,5,5,4,5,5,4,5,5,4,5,5,1,0,0,1,5,5,4,5,5,4,5,5],
[1,1,1,2,2,1,1,1,1,1,1,1,1,1,1,1,1,1,1,1,1,2,2,1,1,1,1,1,1,1,1,1],
[0,0,3,0,0,3,0,0,0,0,0,0,0,3,0,0,3,0,0,0,3,0,0,3,0,3,0,0,3,0,0,0],
[0,0,3,0,0,3,0,0,0,0,0,0,0,3,0,0,3,0,0,0,3,0,0,3,0,3,0,0,3,0,0,0],
[1,1,1,2,2,1,1,1,1,1,1,1,1,1,2,2,1,1,1,1,1,1,1,1,1,1,2,2,1,1,1,1],
]
#